10,10,10,10,10,10,10,10,10,10,10,10,10,10,10,10,10,10,10,10
10,10,10,10,10,10,10,10,10,10,10,10,10,10,10,10,10,10,10,10
10,10,10,10,10,10,10,10,10,10,10,10,10,10,10,10,10,10,10,10
10,10,10,10,10,10,10,10,10,10,10,10,10,10,10,10,10,10,10,10
10,10,10,10,10,10,10,10,10,10,10,10,10,10,10,10,10,10,10,10
0,1,0,1,0,10,10,10,10,10,10,10,10,10,0,1,0,1,0,1
10,10,10,10,10,10,10,10,10,10,10,10,10,10,10,10,10,10,10,10
10,10,10,10,10,10,10,0,1,0,1,10,10,10,10,10,10,10,10,10
10,10,10,10,10,10,10,10,10,10,10,10,10,10,10,10,10,10,10,10
0,1,0,1,0,10,10,10,10,10,10,10,10,10,0,0,0,0,0,0
10,10,10,10,10,10,10,10,10,10,10,10,10,10,10,10,10,10,10,10
10,10,10,10,10,10,10,10,10,10,10,10,10,10,10,10,10,10,10,10
14,15,14,15,14,15,14,15,14,15,14,15,14,15,14,15,14,15,14,15
0,1,8,9,0,1,2,3,0,1,0,2,3,1,0,8,9,1,2,3
4,5,12,13,4,5,6,7,4,5,4,6,7,5,4,12,13,5,6,7
